R 900 900 #resolution is defined and depends on yours max screen width & hieght

NO ./textures/grey_wall.xpm  
SO ./textures/wall1.xpm  
WE ./textures/wall2.xpm     
EA ./textures/stone2.xpm 

S ./textures/luka3.xpm 

F 211,211,211 
C 176,224,230 

    111111  111
    11110111101111111111111111111
111110000000000000000000200000001
10E002000011111111111111111101111
10000000001                101
11111011111               1101111
11000000011               1000001
 11000000011111111111111111000001
 10000000000002000000000000011111
11111000001111111111111101111
    1000001            101
11111000001111111111111101
10002000000000000000002001
11000000001111111111111111
 10000000111
110000000011
100000000011
100000000011            1111
1000000000111111111111111201
1000011110000000000000000011
100001  10000000000000001111
100001111000001111111111111
1000020000000001
1000000000000001
1111101111111111
    111